1111111111111111111111111111
100000000C0000000000000000P1
1001111111111111111111111111
10000000011100C0000000011111
1001110C0010000001000C000111
100C111100000011111000000011
11111111111111111111111100C1
1000000000000000000000C10001
1011111111110111111111010001
100000C000C100000000C1010C01
1110111111111111111111000001
111011000000C111000C11111111
111000C111110000C110000000E1
1111111111111111111111111111