11111111111111111111
1P000000000000000001
10000000000000000001
10000000000000000001
100000000000000000C1
11111111111111111111