1111111111111111111111111111
1E010C010C010C010C010C010C01
110C010C010C010C010C010C0101
11111111111111111111111111C1
1000000000000000000000000001
1C11111111111111111111111111
1000000000000000000000000001
11111111111111111111111111C1
1000000000000000000000000001
1C11111111111111111111111111
1000000000000000000000000001
11111111111111111111111111C1
1P00000000000000000000000001
1111111111111111111111111111