1111111111111111111111111111
1E010C010C010C010C010C010C01
110C010C010C010C010C010C0101
1111111111111111111111111101
110C010C010C010C010C010C0101
10010C010C010C010C010C010C01
1C11111111111111111111111111
10010C010C010C010C010C010C01
110C010C010C010C010C010C0101
1111111111111111111111111101
110C010C010C010C010C010C0101
10010C010C010C010C010C010C01
1C11111111111111111111111111
1000P10000000000000000000001
1111111111111111111111111111